	Union of Soviet Socialist Republics
AD	Principality of Andorra
AE	United Arab Emirates
AF	Islamic Republic of Afghanistan
AG	Antigua and Barbuda
AI	Anguilla
AL	Republic of Albania
AM	Republic of Armenia
AN	Netherlands Antilles
AO	Republic of Angola
AR	Argentine Republic
AT	Republic of Austria
AU	Commonwealth of Australia
AW	Aruba
AX	Ahvenanmaan L?ni
AZ	Republic of Azerbaijan
BA	Bosnia and Herzegovina
BB	Barbados
BD	Bangladesh
BE	Kingdom of Belgium
BF	Burkina Faso
BG	Republic of Bulgaria
BH	Kingdom of Bahrain
BI	Republic of Burundi
BJ	Republic of Benin
BL	Saint Barthelemy
BM	Bermuda
BN	Brunei Darussalam
BO	Plurinational State of Bolivia
BQ	Bonaire, Saint Eustatius and Saba
BR	Federative Republic of Brazil
BS	Commonwealth of The Bahamas
BT	Kingdom of Bhutan
BV	Bouvet Island
BW	Republic of Botswana
BY	Republic of Belarus
BZ	Belize
CA	Canada
CC	Territory of Cocos (Keeling) Islands
CD	Democratic Republic of the Congo
CF	Central African Republic
CG	Republic of the Congo
CH	Switzerland
CI	Republic of C?te d'Ivoire
CK	Cook Islands
CL	Republic of Chile
CM	Republic of Cameroon
CN	People's Republic of China
CO	Republic of Colombia
CR	Republic of Costa Rica
CS	Czechoslovakia
CS	Serbia and Montenegro
CU	Republic of Cuba
CV	Republic of Cabo Verde
CW	Country of Cura?ao
CX	Territory of Christmas Island
CY	Republic of Cyprus
CZ	Czechia
DE	Bundesrepublik Deutschland (bis 1990)
DE	Federal Republic of Germany
DE	German Democratic Republic
DE	Imperium Galliarum
DJ	Republic of Djibouti
DK	Kingdom of Denmark
DM	Dominica
DO	Dominican Republic
DZ	People's Democratic Republic of Algeria
EC	Republic of Ecuador
EE	Republic of Estonia
EG	Arab Republic of Egypt
ER	State of Eritrea
ES	Kingdom of Spain
ET	Federal Democratic Republic of Ethiopia
FI	Republic of Finland
FJ	Republic of Fiji
FK	Falkland Islands
FM	Federated States of Micronesia
FO	Faroe Islands
FR	Republic of France
GA	Gabonese Republic
GB	United Kingdom of Great Britain and Northern Ireland
GD	Grenada
GE	Georgia
GF	Guyane
GG	Bailiwick of Guernsey
GH	Dagomba
GH	Republic of Ghana
GI	Gibraltar
GL	Greenland
GM	Gambia
GN	Republic of Guinea
GP	Guadeloupe
GQ	Republic of Equatorial Guinea
GR	Hellenic Republic
GS	South Georgia and the South Sandwich Islands
GT	Republic of Guatemala
GU	Guam
GW	Republic of Guinea-Bissau
GY	Co-operative Republic of Guyana
HK	Hong Kong Special Administrative Region
HM	Territory of Heard Island and McDonald Islands
HN	Republic of Honduras
HR	Republic of Croatia
HT	Republic of Haiti
HU	Hungary
ID	Republic of Indonesia
IE	Ireland
IL	State of Israel
IM	Isle of Man
IN	Republic of India
IO	British Indian Ocean Territory
IQ	Republic of Iraq
IR	Islamic Republic of Iran
IS	Republic of Iceland
IT	Imperium Romanum
IT	Italian Republic
JE	Bailiwick of Jersey
JM	Jamaica
JO	Hashemite Kingdom of Jordan
JP	Japan
KE	Republic of Kenya
KG	Kyrgyz Republic
KH	Indochine
KH	Kingdom of Cambodia
KI	Republic of Kiribati
KM	Union of the Comoros
KN	Federation of Saint Kitts and Nevis
KP	Democratic People's Republic of Korea
KR	Republic of Korea
KW	State of Kuwait
KY	Cayman Islands
KZ	Republic of Kazakhstan
LA	Lao People's Democratic Republic
LB	Lebanon
LC	Saint Lucia
LI	Principality of Liechtenstein
LK	Democratic Socialist Republic of Sri Lanka
LR	Republic of Liberia
LS	Kingdom of Lesotho
LT	Republic of Lithuania
LU	Grand Duchy of Luxembourg
LV	Republic of Latvia
LY	Libya
MA	Kingdom of Morocco
MC	Principality of Monaco
MD	Republic of Moldova
ME	Montenegro
MF	Saint-Martin
MG	Republic of Madagascar
MH	Republic of the Marshall Islands
MK	North Macedonia
ML	Republic of Mali
MM	Union of Burma
MN	Mongolia
MO	Macau Special Administrative Region
MP	Commonwealth of the Northern Mariana Islands
MQ	Martinique
MR	Islamic Republic of Mauritania
MS	Montserrat
MT	Republic of Malta
MU	Republic of Mauritius
MV	Republic of Maldives
MW	Republic of Malawi
MX	Mexico
MY	Malaysia
MZ	Republic of Mozambique
NA	Republic of Namibia
NC	New Caledonia
NE	Republic of Niger
NF	Territory of Norfolk Island
NG	Federal Republic of Nigeria
NI	Republic of Nicaragua
NL	Kingdom of the Netherlands
NO	Kingdom of Norway
NP	Federal Democratic Republic of Nepal
NR	Nauru
NU	Niue
NZ	New Zealand
OM	Sultanate of Oman
PA	Republic of Panama
PE	Republic of Peru
PF	French Polynesia
PG	Independent State of Papua New Guinea
PH	Republic of the Philippines
PK	Islamic Republic of Pakistan
PL	Republic of Poland
PM	Saint Pierre and Miquelon
PN	Pitcairn, Henderson, Ducie and Oeno Islands
PR	Puerto Rico
PS	Palestine
PT	Portuguese Republic
PW	Republic of Palau
PY	Republic of Paraguay
QA	State of Qatar
RE	Reunion
RO	Rom?nia
RS	Serbia
RU	Russian Federation
RW	Republic of Rwanda
RW	Ruanda-Urundi
SA	Kingdom of Saudi Arabia
SB	Solomon Islands
SC	Republic of Seychelles
SD	Republic of the Sudan
SE	Kingdom of Sweden
SG	Republic of Singapore
SH	Saint Helena, Ascension, and Tristan da Cunha
SI	Republic of Slovenia
SK	Slovak Republic
SL	Republic of Sierra Leone
SM	Repubblica di San Marino
SN	Republic of Senegal
SO	Somalia
SR	Republic of Suriname
SS	South Sudan
ST	Sao Tome and Principe
SV	Republic of El Salvador
SX	Sint Maarten
SY	Imperium Palmyrenum
SY	Syrian Arab Republic
SZ	Eswatini
TC	Turks and Caicos Islands
TD	Republic of Chad
TF	French Southern and Antarctic Lands
TG	Togolese Republic
TH	Kingdom of Thailand
TJ	Republic of Tajikistan
TK	Tokelau
TL	Democratic Republic of Timor-Leste
TM	Turkmenistan
TN	Republic of Tunisia
TO	Kingdom of Tonga
TR	Republic of Turkey
TT	Republic of Trinidad and Tobago
TV	Tuvalu
TW	Taiwan
TZ	United Republic of Tanzania
UA	Bilhorod-Dnistrovskyy City Raion
UA	Ukraine
UG	Republic of Uganda
UG	Toro District
UM	United States Minor Outlying Islands
US	United States
UY	Oriental Republic of Uruguay
UZ	Republic of Uzbekistan
VA	State of the Vatican City
VC	Saint Vincent and the Grenadines
VE	Bolivarian Republic of Venezuela
VG	British Virgin Islands
VI	United States Virgin Islands
VN	Democratic Republic of Vietnam
VN	Republic of Vietnam
VN	Socialist Republic of Vietnam
VU	Republic of Vanuatu
WF	Wallis et Futuna
WS	Independent State of Samoa
XK	Republic of Kosovo
YE	Republic of Yemen
YE	Yemen, Democratic
YT	Mayotte
YU	Federal Republic of Yugoslavia
ZA	Republic of South Africa
ZM	Republic of Zambia
ZW	Republic of Zimbabwe
